""
111111111111111111111111111111
111111111111111111111111111111
111111111111111111111111111111
1153333300@1111111111111111111
11C333331111111111111111111111
111133333331100000000000111111
111111111131103000000000111111
111113333331100011110000111111
1100030C0001100011110300111111
110003000001100011110000111111
111111030001100011111111111111
110000001111100011111111111111
110303030001101011111111111111
110000000001100011111111111111
110300011111130011111111111111
110000000001100011111111111111
110C000C000C000011111111111111
111111111111111111111111111111
111111111111111111111111111111
111111111111111111111111111111
111111111111111111111111111111
111111111111111111111111111111
111111111111111111111111111111
