"Over and Under"
111111111111111111111111111111
111111111111111111111111111111
111111111111111111111111111111
111111111111111111111111111111
111111111111111111111111111111
111111000000010000000111111111
111111000000010000000111111111
11111100000301000C000111111111
111111000000010000000111111111
111000000100010001000111111111
1110@0030100010001030111111111
111000000100010001000111111111
111111000100000001000111111111
11111100010C030C01000111111111
1111110C0100000001000111111111
111111000100000001000111111111
111111111111111111101111111111
111111111111111111101111111111
111111111111111111141111111111
111111111111111111111111111111
111111111111111111111111111111
111111111111111111111111111111