"Stairway to Heaven"
111111111111111111111111111111
111111111111111111111111000041
111111111111111111111101011111
111111111111111130000000011111
111111111111111100000111111111
111111111111111111110111111111
111111111111111111110111111111
1500C00C0005030000000111111111
111111111111111001111111111111
111111111111111000000000305111
111111111111111001111111111111
1500C00C0000000001111111111111
111111111001111111111111111111
111111111001111111111111111111
111111111001111111111111111111
111110000000000030111111111111
111110000000030000111111111111
111110011111111111111111111111
111110011111111111111111111111
1@0000011111111111111111111111
111111111111111111111111111111
111111111111111111111111111111