Through and Through
111111111111111111111111111111
111111111111111111111111111111
111111111111111111111111111111
111111111111111111111111111111
111111111111111111111111111111
111111111111111111111111111111
111111111000030600000@11111111
111111111000000111111111111111
111111111030000600000011111111
1111111111111111000C0011111111
111111111030000600000011111111
11111111100C000100000011111111
111111111000030600000011111111
111111111111111100030011111111
111111111400C00600000011111111
111111111111111111111111111111
111111111111111111111111111111
111111111111111111111111111111
111111111111111111111111111111
111111111111111111111111111111
111111111111111111111111111111
111111111111111111111111111111