"At a Crossroads"
111111111111111111111111111111
111111111111111111111111111111
111111111111111111111111111111
111111111111114111111111111111
111111111111110111111111111111
111111111111110111111111111111
111111111111110111111111111111
111100000111110111110000011111
1111503000C0005000C00030511111
111100000111110111110000011111
111111111111113111111111111111
111111111111110111111111111111
111150C000300050003000C0511111
111111111111110111111111111111
111111111111113111111111111111
111100000111110111110000011111
1111503000C0005000C00030511111
111100000111110111110000011111
111111111111110111111111111111
111111111111110111111111111111
11111111111111@111111111111111
111111111111111111111111111111