"Stop, Drop and Roll"
111111111111111111111111111111
111111111111111111111111111111
111111111111111111111111111111
111111@00500300C00300511111111
111111111011111111111111111111
111111111011111111111111111111
111111111500C00511111111111111
111111111011111111111111111111
111111111011111111111111111111
111111111500305111111111111111
111111111011110111111111111111
111111111011115003051111111111
111111111011111111101111111111
111111111311111111150051111111
111111111011111111111101111111
111111111011111111111101111111
111111111500C0000C005141111111
111111111111111111111111111111
111111111111111111111111111111
111111111111111111111111111111
111111111111111111111111111111
111111111111111111111111111111			