"In the Long Run"
111111111111111111111111111111
111111111111111111111111111111
111111111111111111111111111111
111@03030301110030003000300011
111111111101110111111111111311
111033333301113000300030003011
111011111111110001111111111111
111C03030301110001111111111111
111111111101110001111111111111
111533333351116161111111111111
111000000001110031111111111111
111533333351110001111111111111
1110000C0001113001111111111111
111533333351116161111111111111
111000000000C00001111111111111
111000000011111101111111111111
111111111111111101111111111111
111111111111111141111111111111
111111111111111111111111111111
111111111111111111111111111111
111111111111111111111111111111
111111111111111111111111111111

