"Spiraling In"
111111111111111111111111111111
111111111111111111111111111111
111111111100000C01111111111111
111111111101111101111111111111
111111111101111101111111111111
111111000000000030000001111111
111111011111111111100001111111
111111010000000000100C01111111
111111310011111110100001111111
111111010010030510100001111111
111111010010001410100C01111111
111111010010001110100001111111
111111010010000000100001111111
111111010011111111100C01111111
111111010300000000000001111111
111111011111111111111111111111
11111100005000005000000@111111
111111111101111101111111111111
111111111101111101111111111111
111111111150003051111111111111
111111111111111111111111111111
111111111111111111111111111111
