"In and Out"
111111111111111111111111111111
111111111111111111111111111111
111111111111111111111111111111
111111100000000000000000011111
111111100000000300000000011111
111111101111111111111111011111
111111101111111111111111011111
1111111010000C0000C00001011111
111111101611111111111161011111
111111101611111111111161011111
111111101611111111111161011111
111111101000001111000001011111
111111166003006666003006611111
111111141000001111000001011111
111111101011111111111101011111
111111101011111111111101011111
111111101011111111111101011111
1111111C1500000@00000051C11111
111111101111111111111111011111
111111101111111111111111011111
111111150000000300000000511111
111111111111111111111111111111