"Greener on the Other Side of the Fence"
111111111111111111111111111111
111111111111111111111111111111
111111111111111111111111111111
111111111111111111111111111111
111111ddddddddddddddddddd11111
111111d11111111311111111d11111
111111d1DDDDDDDDDDDDDDD1d11111
111111d1D@030030030030D1d11111
111111d1D0101111111110D1d11111
111111d1D01315K0303013D1d11111
1150k0DCD0101111111310DCD03511
111111d1D3103030303010D1d11111
111111d1D0111111111113D1d11111
111111d1D0300300300300D1d11111
111111d1DDDDDDDDDDDDDDD1d11111
111111d11111111311111111d11111
111111ddddddddddddddddddd11111
111111111111111011111111111111
111111111111111011111111111111
111111111111111411111111111111
111111111111111111111111111111
111111111111111111111111111111

