""
111111111111111111111111111111
111111111111111111111111111111
111@00000000000011111111111111
111110000000000011111111111111
111111111110030011111111111111
111110000000000011111111111111
1111100C0000000010010011111111
111110000000000010010000011111
111111111111110010C10030000011
111110000300000010010000000011
111110000000000010000000000011
111110011111111110000001111011
111110000000000010000101111011
1111100000003000100011C1111011
111111111111110000011101111011
11111C000000000000000001111011
111110000000000000000001111011
111111111111111111111111111411
111111111111111111111111111111
111111111111111111111111111111
111111111111111111111111111111
111111111111111111111111111111