""
111111111115111111111111111111
111111111113111111111111111111
11111@000000000000000111111111
111110111116111111110111111111
111103111116111111110111111111
111100000000000000110111111111
111100111110111110110111111111
150C00100006000010110111111111
111100101113111010110111111111
11110006030C030600113111111111
111110101113111010110111111111
111110100006000010110111111111
111110111110111110110111111111
111110000000000000110111111111
111111111111111111110111111111
111000111111111111110111111111
111040000003000000000111111111
111000111111111111111111111111
111111111111111111111111111111
111111111111111111111111111111
111111111111111111111111111111
111111111111111111111111111111

