"Blockade"
111111111111111111111111111111
111111111111111111111111111111
111111111111111111111111111111
111111111111111111111111111111
11111111111111000C00000C001111
111111111111110111111111101111
11111111000C000000000111131111
11111111011111d111110111000111
11100006011111d111110DDD0k0111
111000060111114111110111000111
111661110111111111110111111111
1110C1110111111111110111111111
11100111000000@000000111111111
111661111111111111111111111111
11100000603060006000K111111111
111000306000603060000111111111
111111111111111111111111111111
111111111111111111111111111111
111111111111111111111111111111
111111111111111111111111111111
111111111111111111111111111111
111111111111111111111111111111

