Chutes and Ladders
111111111111111111111111111111
111111111111111111111111111111
111111111111111111111111111111
111111111511151115111111111111
111111111011101110111111111111
11111@111311130000111111111111
111110111011101113111111111111
11111C111000001110111111111111
111110111611161110111111111111
11111500000000000P11p111111111
111111111611161111110111111111
11111111100C001111110111111111
11111111101110111111C111111111
111111111311130C05110111111111
111111111011101111110111111111
111111111511151111114111111111
111111111111111111111111111111
111111111111111111111111111111
111111111111111111111111111111
111111111111111111111111111111
111111111111111111111111111111
111111111111111111111111111111